11111111111111111111111111111
1C00C0000C000C00C10000000C1C1
11111111011111111101011111101
100C1000010000000000000000001
10111001010011111111111111101
1000000100001E000000000000001
10111111111111111111111111111
10100010000100000000100010CC1
100010001000000000100010000C1
11111111111110111011111111111
1P0010001000101C0010001CCCCC1
100000100010000010001000000C1
11111111111111111111111111111
