11111111111111111111111111111
1C00C0000C000C00C10000000C1C1
11111111011111111101011111101
100C1000010000000000000000001
10111001010011111111111111101
1000000100001E000000000000001
10111111111111111111111111111
1010001000010VV00000100010CC1
100010001V00000000100010000C1
11111111111110111011111111111
11PV10001000101C0010001CCCVC1
100000100010000010001000V00C1
11111111111111111111111111111
