111111111111111111111111111111111111111
1E0000000000000C00000C00000000000000001
101001010010000010100100000001000000001
101001001010101000100100000001010000001
1P0000000C00C0000000000000000000C000001
111111111111111111111111111111111111111
