1111111
1CCCCC1
1CCCCC1
1PCECC1
1CCCCC1
1CCCCC1
1111111
